Western Union	ORGANIZATION
Shukran Jaffer	PERSON
Hindi	LANGUAGE
Urdu	LANGUAGE
Pahar Ganj	LOCATION
river Krishna	LOCATION
Alaka	PERSON
Tamil	LANGUAGE
Tamil Nadu	LOCATION
Santacruz	LOCATION
Vashi	LOCATION
Kavya	PERSON
Pramila	PERSON
Shahani	PERSON
Sibanarayan	PERSON
Kshetramohan	PERSON
Ratnakar	PERSON
Dwarka	LOCATION
Mount Govardhan	LOCATION
Arabic	LANGUAGE
Yeshwantpur	LOCATION